#####D#####
#.......1.#
#.####.##.#
B.#..#..#.#
#.##.####.#
#.0.......#
##I##W#####