#####DB####
I.........#
#.####.##.#
#.#..#..#.#
S1##.#C##.#
#........0#
#####W#####