#O###D####C
#.........#
#.##H#.##.#
#.#..I..#.#
#.##.####0#
#....1....#
#####W#B##S